-	-season-2.ics
Alumni Scrim	alumni-scrim-season-2.ics
Butchers	butchers-season-2.ics
Cobra Kai	cobra-kai-season-2.ics
Corlears Hookers	corlears-hookers-season-2.ics
Dark Rainbows	dark-rainbows-season-2.ics
Denim Demons	denim-demons-season-2.ics
Filthier	filthier-season-2.ics
Fresh Kills	fresh-kills-season-2.ics
Fuzz	fuzz-season-2.ics
Gouging Anklebiters	gouging-anklebiters-season-2.ics
Gremlins	gremlins-season-2.ics
Instant Karma	instant-karma-season-2.ics
Lbs	lbs-season-2.ics
Mega Touch	mega-touch-season-2.ics
Moby Dekes	moby-dekes-season-2.ics
PBR Cup	pbr-cup-season-2.ics
Poutine Machine	poutine-machine-season-2.ics
Renaissance	renaissance-season-2.ics
Riots	riots-season-2.ics
Sky Fighters	sky-fighters-season-2.ics
Skyfighters / Moby Dekes	skyfighters-moby-dekes-season-2.ics
Vertz	vertz-season-2.ics
What the Puck	what-the-puck-season-2.ics
